NO ./texture/north2.xpm
SO ./texture/south2.xpm
WE ./texture/west2.xpm
EA ./texture/east2.xpm
DO ./texture/door2.xpm
S1 ./texture/octo_down.xpm
S2 ./texture/octo_up.xpm

F 143,188,143
C 135,206,235

1111111111111111111111111111111
1222222222222222222222222222221
1222222222222222222222222222221
1222222222222222222222222222221
1222222222222222222222222222221
1222222222222222222222222222221
1222222222222222222222222222221
1222222222222222222222222222221
1222222222222222222222222222221
1222222222222222222222222222221
1000000000000000000000000000001
1000000000000000000000000000001
1000000000000000000000000000001
1000000000000000000000000000001
1000000000000000000000000000001
1000000000000N00000000000000001
1000000000000000000000000000001
1000000000000000000000000000001
1000000000000000000000000000001
1111111111111111111111111111111
