NO ./texture/north2.xpm
SO ./texture/south2.xpm
WE ./texture/west2.xpm
EA ./texture/east2.xpm
DO ./texture/door2.xpm
S1 ./texture/octo_down.xpm
S2 ./texture/octo_up.xpm

F 109,140,188
C 0,3,82




        1111111111111111111111111
        1000000000110000000000001
        1011000001110000000000001
        1007000000000000000000001
111111111011000001110000000000001
100000000011000001110171111111111
11110111111111011100000010001
11117111111111011101010010001
11000000110101711100000010001
10000000700000001100000010001
10000000100000001101010000001
11000001110101011111011710N0111
11110111 1110101 101111010001
11111111 1111111 111111111111
