NO ./texture/north2.xpm
SO ./texture/south2.xpm
WE ./texture/west2.xpm
EA ./texture/east2.xpm
S1 ./texture/octo_down.xpm
S2 ./texture/octo_up.xpm
DO ./texture/door2.xpm

F 109,140,188
C 0,3,82




        1111111111111111111111111
        1000000000000000000000001
        1100000000000000000000001
        1000000200000000000000001
111111111000000000000000000000001
100000000000000000000000000001111
10000000000000000000000000001
10000000000000000000000000001
1000000000000N000000000000001
10000000000000000000000000001
10000000000000000001010000001
11000001110171011111011117101
11110111 1110111 101111010001
11111111 1111111 111111111111
