111111111
1CP00E101
101111111
100000111
111111111
