1111111111111111
1000P00100000001
1011111110111101
1EC0000000010001
1111111111111111
